# Technobabbly verbs
@format ~|ED|ING
actuate|actuated|actuating
adjust
align
amplify|amplified|amplifying
animate|animated|animating
atomise|atomised|atomising
augment
balance|balanced|balancing
bolster
boost
bypass
calibrate|calibrated|calibrating
charge|charged|charging
clog|clogged|clogging
compensate|compensated|compensating
compose|composed|composing
configure|configured|configuring
congest
conjugate|conjugated|conjugating
connect
constrict
construct
couple|coupled|coupling
direct
distribute|distributed|distributing
drench
electrify|electrified|electrifying
energise|energised|energising
escalate|escalated|escalating
equalise|equalised|equalising
excite|excited|exciting
extricate|extricated|extricating
fabricate|fabricated|fabricating
fluctuate|fluctuated|fluctuating
flush
focus
frag|fragged|fragging
gauss
gyrate|gyrated|gyrating
ignite|ignited|igniting
inflect
integrate|integrated|integrating
intensify|intensified|intensifying
invert
ionise|ionised|ionising
isolate|isolated|isolating
kindle|kindled|kindling
loosen
magnify|magnified|magnifying
modify|modified|modifying
moderate|moderated|moderating
modulate|modulated|modulating
neutralise|neutralised|neutralising
nullify|nullified|nullifying
obstruct
organise|organised|organising
oscillate|oscillated|oscillating
plug|plugged|plugging
polarise|polarised|polarising
precipitate|precipitated|precipitating
pressurise|pressurised|pressurising
regulate|regulated|regulating
reinforce|reinforced|reinforcing
resonate|resonated|resonating
reticulate|reticulated|reticulating
reverberate|reverberated|reverberating
reverse|reversed|reversing
rotate|rotated|rotating
route|routed|routing
screw
separate|separated|separating
sharpen
stabilise|stabilised|stabilising
synchronise|synchronise|synchronising
tension
tighten
transfigure|transfigured|transfiguring
transmogrify|transmogrified|transmogrifying
transpose|transposed|transposing
twist
undulate|undulated|undulating
vaporise|vaporised|vaporising
vent
ventilate|ventilated|ventilating
vibrate|vibrated|vibrating
vitalise|vitalised|vitalising
vivify|vivified|vivifying
weave|weaved|weaving
wiggle|wiggled|wiggling
wobble|wobbled|wobbling
