# Transitive verbs that are just a single word
@format ~|S|ED|ING
absuse|abuses|abused|abusing
accept
adore|adores|adored|adoring
admire|admires|admired|admiring
allow
ambush|ambushes|ambushed|ambushing
annoy
answer
arrange|arranges|arranged|arranging
arrest
attack
attract
ask
assure|assures|assured|assuring
avoid
bake|bakes|baked|baking
beat|beats|beat|beating
befriend
bite|bites|bit|biting
break|breaks|broke|breaking
bring|brings|brought|bringing
build|builds|built|building
bully|bullies|bullied|bullying
burn|burns|burnt|burning
buy|buys|bought|buying
call
carry|carries|carried|carrying
capture|captures|captured|capturing
catch|catches|caught|catching
change|changes|changed|changing
check
chew
choke|chokes|choked|choking
choose|chooses|chose|choosing
claim
clean
climb
close|closes|closed|closing
collect
compare|compares|compared|comparing
complete|completes|completed|completing
connect
consider
contact
contain
continue|continues|continued|continuing
control|controls|controlled|controlling
cook
copy|copies|copied|copying
count
create|creates|created|creating
crush|crushes|crushed|crushing
cut|cuts|cut|cutting
damage|damages|damaged|damaging
deal|deals|dealt|dealing
deliver
demand
deny|denies|denied|denying
describe|describes|described|describing
design
despise|despises|despised|despising
destroy
develop
discover
discuss|discusses|discussed|discussing
dislike|dislikes|disliked|disliking
divide|divides|divided|dividing
do|does|did|doing
draw|draws|drew|drawing
dress|dresses|dressed|dressing
drink|drinks|drank|drinking
drive|drives|drove|driving
drop|drops|dropped|dropping
drown
eat|eats|ate|eating
employ
enable|enables|enabled|enabling
encourage|encourages|encouraged|encouraging
endorse|endorses|endorsed|endorsing
enjoy
examine|examines|examined|examining
expect
experience|experiences|experienced|experiencing
explain
express|expresses|expressed|expressing|
extend
face|faces|faced|facing
fasten
feed|feeds|fed|feeding
feel|feels|felt|feeling
fetch|fetches|fetched|fetching
fight|fights|fought|fighting
fill
find|finds|found|finding
finish|finishes|finished|finishing
fold
follow
forbid|forbids|forbade|forbidding
force|forces|forced|forcing
forget|forgets|forgot|forgetting
forgive|forgives|forgave|forgiving
form
frighten
gain
get|gets|got|getting
give|gives|gave|giving
glimpse|glimpses|glimpsed|glimpsing
grow|grows|grew|growing
handle|handles|handled|handling
have|has|had|having
hate|hates|hated|hating
hear|hears|heard|hearing
help
hide|hides|hid|hiding
hit|hits|hit|hitting
hold|holds|held|hiding
hug|hugs|hugged|hugging
hunt
hurt|hurts|hurt|hurting
imagine|imagines|imagined|imagining
improve|improves|improved|improving
include|includes|included|including
indicate|indicates|indicated|indicating
influence|influences|influenced|influencing
inform
introduce|introduces|introduced|introducing
investigate|investigates|investigated|investigating
invite|invites|invited|inviting
involve|involves|involved|involving
join
judge|judges|judged|judging
keep|keeps|kept|keeping
kick
kill
kiss|kisses|kissed|kissing
knit|knits|knitted|knitting
knock
know|knows|knew|knowing
lead|leads|led|leading
leave|leaves|left|leaving
lend|lends|lent|lending
lick
like|likes|liked|liking
link
lose|loses|lost|losing
love|loves|loved|loving
make|makes|made|making
manage|manages|managed|managing
manipulate|manipulates|manipulated|manipulating
mark
measure|measures|measured|measuring
meet|meets|met|meeting
melt
mention
mind
miss|misses|missed|missing
mix|mixes|mixed|mixing
mock
move|moves|moved|moving
need
neglect
notice|notices|noticed|noticing
obey
observe|observes|observed|observing
obtain
offend
offer
open
order
own
pass|passes|passed|passing
paint
pay
peel
pick
pickle|pickles|pickled|pickling
place|places|placed|placing
pollute|pollutes|polluted|polluting
prefer|prefers|preferred|preferring
prepare|prepares|prepared|preparing
present
produce|produces|produced|producing
protect
provide|provides|provided|providing
publish|publishes|published|publishing
pull|pulls|pulled|pulling
pulverise|pulverises|pulverised|pulverising
punch|punches|punched|punching
punish|punishes|punished|punishing
push|pushes|pushed|pushing
raise|raises|raised|raising
reach|reaches|reached|reaching
read|reads|read|reading
realise|realises|realised|realising
receive|receives|received|receiving
recognize|recognizes|recognized|recognizing
record|records|recorded|recording
refuse|refuses|refused|refusing
release|releases|released|releasing
remember
remove|removes|removed|removing
replace|replaces|replaced|replacing
report
represent
require|requires|required|requiring
return
reveal
revoke|revokes|revoked|revoking
ride|rides|rode|riding
ring|rings|rang|ringing
rob|robs|robbed|robbing
rub|rubs|rubbed|rubbing
satisfy|satisfies|satisfied|satisfying
save|saves|saved|saving
sculpt
see|sees|saw|seeing
sell|sells|sold|selling
send|sends|sent|sending
sense|senses|sensed|sensing
serenade|serenades|serenaded|serenading
serve|serves|served|serving
shake|shakes|shook|shaking
share|shares|shared|sharing
shoot|shoots|shot|shooting
shove|shoves|shoved|shoving
show
shrink|shrinks|shrunk|shrinking
shut|shuts|shut|shutting
slap|slaps|slapped|slapping
smell|smells|smelt|smelling
smoke|smokes|smoked|smoking
spot|spots|spotted|spotting
start
stop|stops|stopped|stopping
study|studies|studied|studying
suggest
summon
supply|supplies|supplied|supplying
support
suppress|suppresses|suppressed|suppressing
surprise|surprises|surprised|surprising
survive|survives|survived|surviving
take|takes|took|taking
teach|teaches|taught|teaching
tear|tears|tore|tearing
tell|tells|told|telling
test
thank
threaten
throw|throws|threw|throwing
touch|touches|touched|touching
train
treat
turn
understand|understands|understood|understanding
use|uses|used|using
upset|upsets|upset|upsetting
violate|violates|violated|violating
visit
want
warn
wash|washes|washed|washing
watch|watches|watched|watching
weaken
wear|wears|wore|wearing
whip|whips|whipped|whipping
win|wins|won|winning
wipe|wipes|wiped|wiping
